111111111111111
100000X0000X1P1
1111CE000000001
111111111111111
