111111111111111111111111111111
1P0000000000000000000000000001
101111101111111101111111111101
10000011000X000000000000000001
101011111111111111101111111101
100000000011000000000000X00001
101111111111111011111111100111
100000000110000000000000000001
101111111111111111111011111001
10000X0000CCCCCCCCCCCCC0000001
101111111111111111111111111101
1000000000000000001000C0000001
100000000011000000000000000001
101111111111101111111111110101
111111111111111111111111110011
1011111111111111011111111100E1
111111111111111111111111111111
