111111111111111111111111111111
1P00000C00000000000000C0000001
101111111111111111111011111101
1C0000000000X0000C0000000000C1
101111111111111111111111111101
1C000C00000000000000C0000000C1
101111111111011111111011111101
1C000000X000000C000000000000C1
101111111111111111111111111101
1C00000000000000000000000X00C1
101111111111011111101111111101
1C000C00000C0000000000C00000C1
101111111111111111111111111101
1C000000000000X0000000000000C1
101111111111101111111111111101
1C00000C00000000C0000X000000C1
101111111111111111111011111101
1C00000000000000000000000000E1
101111111111111111111111111101
111111111111111111111111111111
