111111111111111
1P0000110000001
111011011101111
100000000000001
101111111110101
1000000000C0001
101101110111101
100000000000001
101111011E10001
111111111111111
